11111111111111
10001110000C01
10P010K0111101
1000001011C101
1111101C000001
10000010111101
1C1110001C0001
10000011111111
11111011000001
1C000000011101
110C0111C111E1
11111111111111
